Lane,SampleID,Index,# Reads,# Perfect Index Reads,# One Mismatch Index Reads,# of >= Q30 Bases (PF),Mean Quality Score (PF)
1,ENRIQ_neg_cntl_1,TCTCATGATA-TCCACGTGTT,657,583,74,171802,31.81
1,ENRIQ_1,CGAGGCCAAG-CCGGTAACAC,1500985,1428075,72910,404302085,32.35
1,ENRIQ_2,TTCACGAGAC-GTAACAATCT,854128,812520,41608,232053353,32.48
1,ENRIQ_3,GCGTGGATGG-CATTGGTCAA,1094726,1050224,44502,292204141,32.18
1,ENRIQ_4,TCCTGGTTGT-TGCCGGTCAG,1096414,1066812,29602,295716563,32.38
1,ENRIQ_5,TAATTCTGCT-ATTGATGAGA,1005041,911447,93594,269412591,32.26
1,ENRIQ_6,CGCACGACTG-CTGTTGGTCC,1150773,1127767,23006,307228634,32.17
1,ENRIQ_7,GAGGTTAGAC-GCAATACATT,956550,921110,35440,259452441,32.46
1,ENRIQ_8,AACCGAGTTC-TCCAGAGATC,972095,845012,127083,261906010,32.36
1,ENRIQ_9,TGTGATAACT-ATGGCGCCTG,3177333,3040614,136719,856741066,32.37
1,ENRIQ_10,AGTATGCTAC-GGTCTATTAA,2001022,1915177,85845,540629470,32.4
1,ENRIQ_11,GTAACTGAAG-TCGCGACTCC,1362265,1302380,59885,368929375,32.43
1,ENRIQ_12,TCCTCGGACT-CTCTGGCGTT,2248080,2214978,33102,608998852,32.44
1,ENRIQ_13,CTGGAACTGT-GTTAATTACG,2007019,1872030,134989,539816387,32.32
1,ENRIQ_14,GAATATGCGG-TCAGTCTCGT,846218,807152,39066,224775057,32.07
1,ENRIQ_15,GATCGGATAA-CGGCCGATAC,1666049,1528196,137853,445227839,32.17
1,ENRIQ_16,GCTAGACTAT-ATGTCGTATT,1110189,1061859,48330,300541468,32.43
1,ENRIQ_17,AGCTACTATA-GCCATATAAC,1247247,1192160,55087,331834862,32.09
1,ENRIQ_18,CCACCGGAGT-CATGGCAGGC,1979873,1922913,56960,533950242,32.36
1,ENRIQ_19,CTTACCGCAC-ATAGGTCTTA,1727245,1653498,73747,467665203,32.43
1,ENRIQ_20,TTAGGATATC-CCATGGTATA,2174263,2060576,113687,580728009,32.18
1,ENRIQ_21,TTATACGCGA-AACAGACGGC,1276692,1227098,49594,337876473,31.99
1,ENRIQ_22,CGCTTAGAAT-TATCACTCTG,1010658,967465,43193,274257749,32.46
1,ENRIQ_23,CCGAAGCGCT-ATAGTTAGCA,1122405,1067910,54495,300637249,32.24
1,ENRIQ_24,CACTATCAAC-CATTAACTGA,1343255,1096141,247114,362550682,32.37
1,ENRIQ_25,TTGCTCTATT-TCAAGGTCAC,2719504,2405422,314082,729184214,32.27
1,ENRIQ_26,TTACAGTTAG-ATATGCATGT,437919,415667,22252,117588537,32.29
1,ENRIQ_27,CTAAGTACGC-TAGGTATGTT,3197714,3034721,162993,855093539,32.23
1,ENRIQ_28,TAGTTCGGTA-CTACACATGG,1918669,1860503,58166,515802190,32.31
1,ENRIQ_29,CTATTACTAC-GGAGAGACTC,1570827,1427453,143374,420238141,32.23
1,ENRIQ_30,TAGCATAACC-TGCGCATAGC,1051380,1015012,36368,282069408,32.27
1,ENRIQ_31,ACTCTATTGT-CATATGCGAT,1181275,1136162,45113,315377418,32.2
1,ENRIQ_32,TAGTGGAAGC-TATAGGTACT,2153771,2087890,65881,577530837,32.26
1,ENRIQ_33,CGCCATATCT-ATCTCCGGTC,1966837,1882681,84156,524037000,32.17
1,ENRIQ_34,GCTTCATATT-AGGCTGAACG,2639107,1836010,803097,710610555,32.34
1,ENRIQ_35,ACTAGCGCTA-GAGGAAGTAA,1911004,1856998,54006,514353611,32.34
1,ENRIQ_36,GCTCTTAACT-GGTGGACGTG,3905852,3766539,139313,1053662509,32.38
1,ENRIQ_37,GTGGTATCTG-AGATAGTAGC,1231249,1154481,76768,329049250,32.17
1,ENRIQ_38,TGACGGCCGT-ATGGTTGACT,425458,406750,18708,114255696,32.3
1,ENRIQ_39,CAGTAATTAC-TACCGCCTCG,1417101,1368076,49025,381893158,32.35
1,ENRIQ_40,TACAAGACTT-TGAACACCTG,1986469,1863049,123420,536114812,32.39
1,ENRIQ_41,CTGTGGTGAC-CCTGTCTGTC,2169077,2121609,47468,588013833,32.45
1,ENRIQ_42,CTCCACTAAT-AACAAGTACA,2464317,2340598,123719,667324749,32.43
1,ENRIQ_43,ATAGTTAGCA-CTACTTAGAG,2345784,2251871,93913,622805958,32.05
1,ENRIQ_44,ATAGGTCTTA-CTGTGGTGAC,4228004,4094566,133438,1135835656,32.29
1,ENRIQ_45,TTCTTAACCA-GGTATGTAGA,1262081,1216579,45502,333779426,31.98
1,ENRIQ_46,AAGGAAGAGT-GCCTAACGTG,1086148,1046045,40103,292231370,32.33
1,ENRIQ_47,GGAAGGAGAC-AGACTCACCA,1608040,1455225,152815,435826070,32.45
1,ENRIQ_48,TGAACGCGGA-TCCTTCGAAG,1681259,1602261,78998,446876414,32.08
1,ENRIQ_49,CCTGCAACCT-CTGACTCTAC,1016138,981566,34572,273194865,32.3
1,ENRIQ_50,TTCATGGTTC-TGACAATGTC,2391550,2230740,160810,645915393,32.39
1,ENRIQ_51,ATCCTCTCAA-GCCTTGCGGA,2082598,1545071,537527,550455135,31.97
1,ENRIQ_52,CACTAGACCA-ATAAGGCAGT,1300612,1250397,50215,344286891,31.99
1,ENRIQ_53,ATTATCCACT-TACGTGCGTA,1535253,1428327,106926,412459855,32.31
1,ENRIQ_54,ATGGCGTGCC-ACTTCAAGCG,2369266,2279095,90171,633583221,32.21
1,ENRIQ_55,TCCAGAGATC-TGAAGTGCAG,1402870,1094367,308503,380426063,32.45
1,ENRIQ_56,ATGTCCAGCA-TTGTCCGCTG,1788018,1704373,83645,476314574,32.12
1,ENRIQ_57,CAACGTTCGG-ATGCGGATCC,1716655,1653237,63418,455327141,32.04
1,ENRIQ_58,GCGTATTAAT-CAACACCGCA,1612437,1517538,94899,434887422,32.37
1,ENRIQ_59,GTTGTGACTA-TCCGTTATGT,1804900,1720193,84707,474337897,31.95
1,ENRIQ_60,TCTCAATACC-CGCGAACGTC,828165,779004,49161,220100052,32.1
1,ENRIQ_61,AAGCATCTTG-TTGTTGAATG,1162204,1129437,32767,310370784,32.18
1,ENRIQ_62,TCAGTCTCGT-ATAATCCGTG,888781,859354,29427,238905942,32.31
1,ENRIQ_neg_cntl_2,TGCAAGATAA-CCGTCCTCAA,460,437,23,117601,31.34
1,Undetermined,Undetermined,6537575,6537575,0,1479539151,29.7
